一	①
丁	玎
七	⑦
万	萭
丈	扙
三	彡
上	仩
下	芐
不	芣
与	玙
丑	忸
专	抟
且	苴
世	迣
丘	坵
丙	眪
业	鄴
丛	苁
东	崬
丝	噝
丢	丟
两	倆
严	嚴
丧	喪
个	個
丫	吖
中	狆
丰	仹
串	賗
临	臨
丸	汍
丹	冄
为	潙
主	炷
丽	婯
举	舉
乃	釢
久	玖
么	庅
义	義
之	と
乌	烏
乍	咋
乎	苸
乏	疺
乐	泺
乔	喬
乘	塖
乙	乁
九	勼
乞	阣
也	竾
习	習
乡	芗
书	書
买	荬
乱	亂
乾	墘
了	孒
争	踭
事	倳
二	②
于	纡
亏	扝
云	囩
互	沍
五	伍
井	丼
亚	亞
亡	匄
亢	囥
交	茭
亦	洂
产	浐
亨	悙
亩	畝
享	啍
京	倞
亭	渟
亮	煷
亲	儭
人	亾
亿	億
仁	芢
仅	僅
仆	圤
今	妗
介	夰
从	苁
仓	仺
他	彵
仗	扙
付	苻
仙	佡
代	笩
令	泠
以	姒
仪	儀
们	們
仰	卬
价	價
任	姙
份	妢
仿	汸
企	佱
伊	吚
伍	⑤
伏	茯
伐	浌
休	咻
众	衆
优	沋
伙	钬
会	浍
伞	傘
伟	偉
传	伝
伤	傷
伦	囵
伪	沩
估	诂
伴	柈
伸	訷
似	姒
但	泹
位	莅
低	彽
住	炷
佑	祐
体	軆
何	哬
余	悇
佛	仏
作	莋
你	沵
佣	砽
佩	姵
例	唎
供	栱
依	畩
侠	浹
侣	佀
侦	浈
侧	側
侨	喬
侯	糇
侵	埐
便	楩
促	娖
俄	皒
俊	浚
俏	佾
保	湺
俞	揄
俩	唡
俭	倹
修	俢
俯	椨
俱	倶
俺	唵
倍	俻
倒	箌
倔	崛
候	糇
倚	掎
借	徣
倦	惓
倪	淣
债	債
值	惪
倾	傾
假	徦
偏	媥
做	莋
停	渟
健	揵
偶	耦
偷	偸
傍	徬
催	慛
傲	謸
像	潒
僚	獠
僵	壃
儒	濡
儿	ル
允	狁
元	沅
兄	兇
充	茺
兆	狣
先	姺
光	洸
克	尅
免	凂
兑	兌
兔	兎
党	黨
兜	兠
入	叺
全	洤
八	仈
公	厷
六	陸
兰	蘭
共	珙
关	関
兴	興
兵	娦
其	娸
具	倶
典	敟
养	養
兼	凲
兽	獣
内	禸
冈	罓
冉	姌
册	冊
再	侢
冒	萺
写	冩
军	軍
农	哝
冠	蒄
冤	寃
冬	笗
冯	溤
冰	栤
冲	沖
决	吷
况	況
冷	唥
冻	岽
净	凈
准	痽
凉	涼
凋	蜩
凌	夌
减	諴
几	凢
凡	汎
凤	鳯
凭	憑
凯	剀
凰	瑝
凶	兇
出	炪
函	凾
刀	叨
刃	刄
分	汾
切	苆
刊	刋
刑	鉶
划	劃
列	烮
刘	嚠
则	荝
刚	碙
创	創
删	剼
判	叛
刨	铇
利	悡
别	莂
刮	剮
到	菿
制	淛
刷	唰
刹	閷
刺	剌
刻	尅
剃	珶
削	萷
前	湔
剐	剮
剑	劍
剥	剝
剧	涺
剩	乗
剪	彅
副	諨
割	剨
劈	噼
力	劦
劝	勧
办	刅
功	糼
加	咖
务	務
劣	挘
动	憅
助	莇
努	怓
劲	勁
劳	崂
势	勢
勇	湧
勋	勛
勒	嘞
勤	懄
勺	汋
勾	芶
勿	匢
匀	枃
包	笣
匆	茐
化	囮
北	苝
匪	厞
匹	苉
区	岖
医	悘
匿	嫟
十	拾
千	芉
升	圱
午	吘
半	柈
华	澕
协	拹
卑	萆
卓	婥
单	啴
卖	賣
南	遖
占	颭
卡	鉲
卢	盧
卧	臥
卫	衞
卯	茆
印	茚
危	佹
即	旣
却	卻
卷	捲
卸	啣
厂	廠
厄	苊
厅	廰
历	呖
厉	疠
压	壓
厌	厭
厕	厠
原	厡
厨	廚
去	厾
县	縣
参	傪
又	叒
叉	紁
及	彶
友	伖
双	叒
发	潑
叔	埱
取	掫
受	辤
变	變
叙	溆
叛	判
叠	疉
口	囗
古	咕
句	呴
另	叧
只	呮
叫	嘂
召	佋
叭	朳
叮	汀
可	妸
台	珆
右	祐
叶	旪
号	呺
司	呞
叹	嘆
叼	汈
吃	阣
各	茖
合	匼
吉	咭
吊	铞
同	哃
名	洺
后	後
吐	汢
向	姠
吓	圷
吕	焒
吗	嬤
君	焄
吝	悋
吞	昋
吟	荶
否	娝
吧	妑
吨	沌
吩	玢
含	浛
听	厛
吭	妔
启	晵
吱	汥
吴	呉
吵	訬
吸	扱
吹	欥
吻	沕
吼	犼
吾	圄
呀	吖
呆	槑
呈	珵
告	哠
呐	妠
呕	嘔
员	園
呛	濸
呜	嗚
呢	迡
周	淍
味	菋
呵	哬
呸	怌
呼	苸
命	掵
咆	垉
和	啝
咏	怺
咙	茏
咨	恣
咬	吆
咱	洎
咳	嗑
品	闆
哄	晎
哈	铪
哉	酨
响	姠
哎	餀
哑	啞
哗	蕐
哟	喲
哥	滒
哦	呃
哮	涍
哲	悊
哺	誧
哼	涥
唆	逡
唇	脣
唉	呃
唐	瑭
唤	喚
唯	惟
唱	晿
啃	肻
商	啇
啊	娿
啥	倽
啦	菈
啼	渧
喂	嵔
善	僐
喉	糇
喊	諴
喘	遄
喜	禧
喝	曷
喧	媗
喷	濆
嗅	溴
嗓	鎟
嗡	滃
嘎	嗄
嘘	歔
嘛	嫲
嘱	瞩
嘲	謿
嘴	觜
嘶	凘
嘿	潶
器	噐
噪	璪
嚷	孃
囊	灢
四	④
回	冋
因	洇
团	團
园	圎
困	涃
围	圍
固	凅
国	國
图	圖
圆	園
圈	圜
土	汢
圣	聖
在	茬
地	哋
场	畼
址	歮
均	汮
坊	汸
坏	壞
坐	唑
坑	妔
块	赽
坚	堅
坛	墵
坟	墳
坠	墜
坡	岥
坤	堒
坦	钽
坪	岼
垂	箠
垃	柆
垄	泷
型	侀
垦	恳
城	峸
埔	逋
培	掊
基	樭
堂	漟
堆	碓
堕	憜
堤	諟
堵	陼
塌	禢
塑	愬
塔	嗒
塘	溏
塞	噻
填	瑱
境	璄
墓	募
墙	嫱
增	熷
墟	歔
墨	嚜
士	仕
壮	匨
声	殸
壳	涜
壶	壺
处	處
备	備
复	復
夏	嗄
夕	汐
外	迯
多	哆
夜	液
够	夠
夥	钬
大	汏
天	兲
太	忲
夫	玞
央	姎
失	妷
头	頭
夸	洿
夹	夾
夺	奪
奇	渏
奈	柰
奉	唪
奋	奮
奎	喹
奏	楱
奔	渀
奖	奨
奥	奧
女	囡
奴	伮
奶	艿
奸	奷
她	咜
好	恏
如	洳
妆	妝
妈	媽
妖	岆
妙	仯
妥	鋖
妹	妺
妻	悽
姑	菇
姓	狌
委	逶
姚	烑
姜	葁
姥	粩
姨	侇
姻	絪
姿	恣
威	媙
娃	哇
娄	溇
娇	嬌
娜	哪
娟	涓
娥	皒
娱	娯
娶	婜
婆	嘙
婉	啘
婚	殙
婪	漤
婴	璎
婶	嬸
婿	胥
嫁	糘
嫂	溲
嫌	溓
嫩	嫰
子	ふ
孔	芤
孕	夃
字	牸
存	洊
孙	孫
孝	涍
孟	掹
季	悸
孤	箛
学	敩
孩	陔
孪	孿
孽	糵
宁	苧
它	咜
宇	荢
守	垨
安	鮟
宋	浨
完	唍
宏	宖
宗	崈
官	菅
定	萣
宝	寶
实	實
宠	寵
审	谉
客	愙
宣	媗
室	厔
宫	営
害	嗐
宴	匽
家	傢
容	嫆
宽	寬
宾	濱
宿	蹜
寅	夤
密	滵
寇	簆
富	冨
寝	寑
察	镲
寸	籿
对	怼
寺	峙
寻	浔
寿	壽
封	崶
将	將
尉	墛
尊	澊
小	尒
少	仯
尔	尒
尚	尙
尝	甞
就	僦
尸	迉
尹	吚
尺	呎
尼	胒
尽	浕
尾	屗
尿	杘
局	挶
屁	庇
层	層
居	劇
屉	屟
届	屆
屋	偓
屎	屍
屏	屛
展	蹍
属	屬
屠	廜
屡	屢
山	屾
岁	嵗
岂	豈
岗	罓
岛	島
岩	啱
岭	玪
岳	捳
峡	浹
峦	欒
峨	睋
峰	峯
峻	浚
崇	漴
崔	慛
崩	镚
巍	蘶
川	巛
州	詶
巡	廵
巢	漅
工	笁
左	咗
巨	姖
巫	莁
差	槎
已	巳
巴	妑
巾	凧
市	巿
布	鈽
帅	帥
帆	汎
师	溮
希	唏
帐	賬
帕	啪
帖	萜
帝	渧
带	帶
帮	幇
常	瑺
帽	萺
幅	諨
幌	縨
幕	募
干	迀
平	岼
年	姩
并	並
幸	圉
幻	抝
幼	孧
幽	豳
广	広
庄	圧
序	垿
庐	廬
库	厙
应	應
底	疧
店	扂
庙	庿
庚	菮
府	椨
庞	厐
废	廢
度	喥
座	蓙
庭	侹
康	嫝
庸	滽
廊	蓢
廓	霩
廖	漻
延	娫
廷	侹
建	踺
开	閞
异	異
弃	棄
弄	挵
式	鉽
弓	弖
引	吲
弘	宖
弛	肔
弟	弚
张	張
弦	妶
弯	塆
弱	弜
强	強
归	歸
当	當
录	淥
彤	浵
彩	埰
彪	滮
彭	憉
彻	沏
往	暀
征	姃
径	徑
很	佷
徊	佪
律	侓
徐	俆
徒	徙
得	嘚
徘	棑
循	揗
微	嶶
德	徳
徽	幑
心	杺
必	怭
忍	涊
志	梽
忘	莣
忙	杧
忠	筗
忧	沋
快	赽
念	淰
忽	唿
怀	懷
态	忲
怒	伮
怔	姃
怕	啪
怜	憐
思	偲
急	喼
性	悻
怨	葾
怯	愜
总	縂
恋	戀
恒	恆
恨	悢
恩	慁
恭	塨
恳	垦
恶	悪
恼	悩
悄	佾
悔	珻
悟	圄
悠	滺
患	漶
悦	哾
悲	蕜
情	凊
惊	驚
惜	厝
惨	參
惩	懲
惭	慙
惯	遦
惰	媠
惶	瑝
惺	瑆
愁	僽
愈	匬
愉	揄
意	嬑
感	憾
愤	濆
愧	隗
愿	蒝
慈	濨
慌	巟
慢	嫚
慰	墛
慷	嵻
憎	璔
懂	慬
懈	澥
懊	襖
懒	攋
懦	穤
戏	戱
成	荿
我	莪
戒	悈
或	戓
战	戰
戚	嘁
戳	戥
戴	瀻
户	戶
所	葰
扁	碥
扇	傓
手	掱
才	財
扎	紥
扑	圤
扒	朳
打	咑
托	仛
扛	摃
扣	釦
执	秇
扩	拡
扫	掃
扬	婸
扭	沑
扮	汾
扰	擾
扶	荴
批	纰
抄	莏
抉	決
把	妑
抒	杼
抖	鬦
抗	忼
折	菥
抛	拋
抠	摳
抡	囵
抢	熗
护	戶
报	蕔
披	怶
抬	孡
抱	砲
抹	沬
押	呷
抽	菗
担	泹
拈	秥
拉	菈
拌	絆
拍	啪
拎	柃
拐	枴
拒	岠
拓	沰
拔	菝
拖	柂
拘	佝
拙	炪
招	妱
拜	湃
拟	抳
拢	泷
拥	砽
拨	妭
择	萚
括	葀
拱	珙
拷	洘
拼	拚
拽	跩
拾	湁
拿	嗱
持	歭
挂	啩
指	栺
按	洝
挑	狣
挛	孌
挟	挾
挠	撓
挡	澢
挣	諍
挤	哜
挥	媈
振	桭
挺	侹
挽	梚
捂	圄
捅	硧
捆	涃
捉	浞
捎	哨
捏	涅
捐	涓
捕	峬
捞	崂
损	損
捡	撿
换	換
捣	搗
捧	唪
据	琚
捶	腄
捷	啑
掀	锨
授	涭
掉	鋽
掌	礃
掏	匋
掐	拤
排	棑
掘	崛
掠	稤
接	帹
控	啌
推	蓷
掩	殗
掺	傪
揉	渘
揍	楱
描	媌
提	諟
插	揷
握	楃
揣	遄
揪	啾
援	瑗
揽	灠
搁	擱
搂	嵝
搓	髊
搜	溲
搞	鎬
搭	溚
摄	摂
摆	擺
摇	愮
摘	擿
摧	凗
摩	嚤
摸	嗼
撅	瘚
撇	潎
撑	撐
撒	潵
撕	凘
撞	獞
撤	徹
撩	嫽
撬	毳
播	譒
擂	檑
操	懆
擒	檎
擦	攃
攀	襻
攒	瓒
支	伎
收	荍
改	妀
攻	糼
放	倣
政	炡
故	诂
敌	敵
敏	勄
救	慦
敖	獓
教	嘋
敛	潋
敝	獙
敢	噉
散	潵
敬	擏
数	薮
敲	毃
文	妏
斑	癍
斗	乧
斤	釿
斧	釡
斩	斬
断	斷
斯	凘
新	噺
方	汸
施	湤
旁	臱
旅	膂
旋	嫙
族	蔟
无	嘸
既	旣
日	ㄖ
旦	狚
旧	舊
早	皁
旬	洵
旭	旮
旱	猂
时	溡
旷	纩
旺	忹
昂	昻
昆	崐
昌	誯
明	眀
昏	涽
易	昜
昔	厝
星	暒
映	眏
春	舂
昨	葃
是	湜
晃	愰
晋	晉
晒	曬
晓	哓
晕	暈
晚	脕
晦	珻
晨	曟
景	憬
晴	啨
晶	瞐
智	潪
晾	涼
暂	暫
暇	叚
暑	濐
暖	煖
暴	懪
曲	浀
更	浭
曹	蓸
曼	嫚
曾	嶒
替	櫕
最	朂
月	仴
有	洧
朋	萠
服	棴
朗	蓢
望	朢
朝	謿
期	剘
木	朩
未	沬
末	沬
本	夲
术	朮
朱	咮
朴	圤
朵	朶
机	僟
杀	摋
杂	卆
权	權
杏	莕
材	財
村	籿
杖	粀
杜	荰
束	娕
杠	釭
条	條
来	唻
杨	昜
杭	忼
杯	柸
杰	傑
松	菘
板	闆
构	媾
枉	忹
析	唽
枕	忱
林	啉
果	淉
枝	汥
枣	栆
枪	熗
枫	猦
枯	喖
架	泇
柄	窉
某	湈
染	媣
柔	渘
柜	匱
查	楂
柱	炷
柳	栁
柴	枈
柿	枾
标	摽
栈	棧
栋	崬
栏	孄
树	樹
栓	拴
样	樣
核	劾
根	艮
格	咯
栽	酨
桂	蓕
桃	洮
桌	棹
桐	秱
桑	鎟
档	澢
桥	喬
桶	硧
梁	樑
梅	烸
梢	哨
梦	夢
梨	悡
梭	逡
梯	珶
械	悈
检	撿
棉	婂
棋	諆
棍	輥
棒	蜯
棕	琮
棚	堋
棠	橖
森	潹
棵	錁
棺	菅
椅	掎
植	淔
椰	倻
楚	椘
楷	揩
楼	溇
概	漑
榔	蓈
榜	徬
榨	搾
榴	媹
模	嗼
横	橫
樱	璎
橡	潒
橱	廚
欠	芡
次	佽
欢	歡
欣	俽
欧	瓯
欲	慾
欺	剘
款	窾
歉	嗛
歌	戨
止	圵
正	囸
此	泚
步	荹
武	娬
歧	忮
死	屍
歼	姧
殉	咰
殊	姝
残	殘
殴	瓯
段	葮
毁	毇
毅	藙
母	毋
每	烸
毒	毐
比	仳
毕	滭
毙	斃
毛	毝
民	姄
气	氣
水	渁
永	怺
汁	汥
求	浗
汇	匯
汉	漢
汕	訕
汗	汙
汛	卂
汝	肗
江	茳
池	肔
污	汚
汤	饧
汪	忹
汰	呔
沈	瀋
沉	冗
沙	乷
沟	芶
没	莈
沦	囵
沧	獊
沪	戶
沫	沬
河	菏
油	怞
治	菭
沽	钴
沾	跕
泄	绁
泉	葲
法	琺
泛	疺
泡	垉
波	菠
泣	淇
泥	狔
注	炷
泪	汨
泰	溙
泳	怺
泻	瀉
泼	秡
泽	澤
洋	樣
洒	灑
洗	冼
洛	詻
洞	狪
津	珒
洪	葓
洲	詶
活	萿
洼	哇
派	哌
流	蓅
浅	淺
浆	槳
测	恻
济	哜
浑	渾
浓	哝
浙	淅
浩	滘
浪	烺
浮	捊
海	嗨
浸	锓
涂	凃
涉	渉
涌	悀
涕	珶
涛	濤
涝	崂
涡	煱
润	潤
涩	澀
涵	凾
淋	啉
淑	蔋
淘	匋
淡	惔
淤	菸
淫	婬
淬	濢
淮	准
深	堔
淳	錞
混	婫
淹	殗
添	婖
清	凊
渊	棩
渗	椮
渝	揄
渡	喥
渣	碴
温	溫
渴	渇
游	遊
渺	緲
湖	煳
湛	偡
湾	塆
湿	濕
溃	潰
溉	漑
源	羱
溜	媹
溪	渓
溶	嫆
滁	蒢
滋	稵
滑	磆
滔	瑫
滚	蔉
满	慲
滤	慮
滥	嚂
滨	璸
滴	嘀
漂	慓
漏	屚
演	湮
漠	嗼
漫	嫚
漾	羕
潘	瀋
潜	濳
潭	憛
潮	謿
澄	僜
澈	瞮
澜	瀾
澡	璪
澳	奧
激	噭
瀑	鑤
灌	潅
火	焱
灭	搣
灯	燈
灰	洃
灵	靈
灾	災
炉	爐
炎	烾
炕	忼
炬	岠
炭	湠
炮	垉
炯	泂
炸	怍
点	點
炼	煉
烁	爍
烂	灡
烈	烮
烙	絡
烟	煙
烤	栲
烦	煩
烧	燒
热	慹
焉	漹
焊	猂
焦	潐
焰	熖
然	嘫
煌	瑝
煞	繺
煤	湈
照	燳
煮	煑
熊	熋
熔	嫆
熙	凞
熟	孰
燃	嘫
燎	獠
燕	嬿
燥	璪
爆	嚗
爬	瓟
爱	嬡
爵	嚼
爷	爺
爸	妑
爹	嗲
爽	摤
片	爿
版	蝂
牌	簰
牙	厊
牛	犇
牟	哞
牢	窂
物	粅
牲	狌
牵	撁
牺	犠
犊	渎
犬	吠
犯	氾
状	匨
犹	沋
狂	誑
狗	豞
狠	哏
狡	烄
独	獨
狭	浹
狮	浉
狱	獄
狼	哴
猎	獵
猛	掹
猩	睲
猪	蕏
猫	貓
献	獻
猴	糇
猾	磆
玄	玆
率	卛
玉	砡
王	迋
玛	犸
玩	琓
玫	坆
环	寰
现	哯
玲	玪
玻	箥
珊	姍
珍	沴
珠	咮
班	癍
球	浗
琅	哴
琐	鎖
琳	啉
琴	噖
瑶	愮
瓜	呱
瓦	咓
瓶	甁
甘	苷
甚	卙
甜	甛
生	泩
用	鼡
甯	苧
田	甶
由	甴
甲	曱
申	妽
电	電
男	莮
画	畵
界	鎅
畏	嵔
畔	溿
留	畱
略	畧
番	畨
畴	帱
疆	彊
疑	寲
疗	療
疚	咎
疯	瘋
疼	庝
病	疒
痒	癢
痘	哣
痛	痌
瘤	媹
瘦	痩
瘪	癟
登	憕
白	皛
百	咟
皂	唣
的	哋
皆	湝
皇	瑝
皮	怶
皱	皺
盆	湓
盈	盁
益	谥
盐	鹽
监	盬
盒	盉
盖	葢
盗	盜
盘	盤
盛	墭
盟	擝
目	朩
盯	饤
盲	吂
直	矗
相	楿
盼	昐
省	渻
眉	葿
真	嫃
眨	喳
眩	妶
眯	侎
眶	洭
睁	諍
睛	聙
睡	腄
睬	棌
瞄	媌
瞎	磍
瞒	慲
瞥	潎
瞧	趭
瞪	簦
瞬	橓
矛	罞
知	倁
矩	怇
矮	婑
石	坧
矿	纩
码	犸
砂	唦
砍	歃
研	妍
砖	磚
砰	泙
破	岥
砸	咂
础	绌
硕	碩
硬	哽
确	確
碉	淍
碎	誶
碗	涴
碟	渫
碰	湴
碳	湠
碴	楂
磁	濨
磅	嫎
磊	藞
磕	溘
磨	嚤
磷	潾
示	沶
社	涻
祖	袓
祝	柷
神	鉮
票	嘌
祸	禍
禁	噤
福	湢
离	蓠
禽	噙
禾	秝
秀	莠
私	俬
秃	禿
秋	偢
种	種
科	萪
秒	仯
租	蒩
秦	蓁
积	積
称	稱
移	簃
稀	浠
程	珵
稍	哨
税	挩
稚	雉
稠	婤
稳	穏
稻	稲
稼	糘
稿	鎬
穴	泬
穷	窮
空	涳
穿	瑏
突	湥
窃	苆
窄	搾
窍	竅
窑	窰
窗	囱
窘	僒
窝	窉
窟	崫
窥	窺
立	竝
竖	竪
站	跕
竞	競
竟	獍
章	嶂
竣	浚
童	僮
端	鍴
竹	艸
竿	芉
笔	毣
笛	廸
符	苻
笨	苯
第	苐
笼	茏
筋	荕
筐	筺
筑	茿
筒	茼
答	荅
策	憡
筛	篩
筹	薵
签	簽
简	彅
算	匴
管	涫
箩	儸
箱	葙
篇	萹
篓	溇
篙	禞
篮	藍
米	洣
类	類
粉	帉
粘	秥
粤	粵
粮	悢
粹	濢
精	棈
糊	煳
糕	溔
糖	溏
糙	鐰
糟	蹧
糠	嵻
糯	穤
系	係
素	嫊
索	鎍
紧	緊
紫	橴
累	蔂
繁	瀿
纠	糾
红	葒
纤	汘
约	箹
纪	汜
纯	蒓
纲	罁
纳	妠
纵	枞
纷	妢
纸	衹
纹	鈫
纺	汸
纽	狃
线	線
练	煉
组	蒩
绅	訷
细	細
织	枳
终	蔠
绍	袑
经	經
绑	垹
绒	絨
结	結
绕	隢
绘	浍
绚	絢
络	絡
绝	蕝
绞	烄
统	統
绢	涓
绥	浽
绪	緒
续	續
绰	焯
绳	繩
维	惟
绵	婂
绸	皗
综	琮
绽	綻
绿	淥
缀	綴
缆	灠
缎	葮
缓	緩
编	揙
缘	緣
缝	漨
缠	瀍
缩	縮
缴	儌
缸	矼
缺	蒛
罐	潅
网	蛧
罕	癷
罗	囉
罚	藅
罪	嶵
羊	咩
美	羙
羔	餻
羚	玪
羞	饈
羡	羨
群	羣
翁	暡
翅	趐
翘	趬
翠	濢
翻	飜
老	荖
考	栲
者	鍺
而	洏
耐	恧
耕	畊
耗	秏
耘	秐
耳	洱
耶	倻
耸	聳
耻	恥
聂	嗫
聊	窷
聋	聾
职	轵
联	聅
聘	娉
聚	藂
肃	歗
肉	禸
肋	叻
肛	釭
股	骰
肢	汥
肤	膚
肥	萉
肯	肻
育	唷
肺	腓
肾	腎
肿	妕
胁	脅
胃	媦
胆	狚
背	揹
胖	眫
胜	夝
胞	菢
胡	箶
胶	烄
胸	洶
脉	霡
脏	賍
脑	悩
脓	哝
脚	腳
脱	脫
脸	臉
脾	裨
腆	睓
腊	臘
腥	睲
腰	崾
腻	膩
腾	駦
腿	蹆
膀	嫎
膘	鏢
膜	嗼
臣	烥
自	洎
臭	溴
至	臸
致	臸
舌	舙
舍	舎
舒	忬
舔	婖
舜	橓
舞	橆
舟	洀
般	瘢
良	悢
色	脃
艳	滟
艺	兿
艾	銰
节	兯
芒	笀
芜	蕪
芝	芷
芦	廬
芬	棼
芭	妑
花	埖
芳	淓
芽	厊
苍	芲
苏	蘇
苑	夗
苗	媌
苛	岢
若	婼
苦	楛
英	渶
苹	泙
范	笵
茄	苆
茅	罞
茎	莖
茨	垐
茫	汒
茵	筃
茶	嗏
茹	筎
荆	荊
草	愺
荐	薦
荒	巟
荡	蕩
药	葯
荷	嗬
莎	莏
莫	嗼
莲	嗹
获	镬
莹	瑩
莽	漭
菊	匊
菌	箘
菜	婇
菩	箁
菱	夌
菲	婔
萄	匋
萌	萠
萍	泙
萎	崣
萝	囉
营	營
萧	簘
萨	蕯
葛	噶
葡	匍
董	蓳
葫	煳
葬	髒
葱	茐
蒂	渧
蒋	蔣
蒙	懞
蒜	祘
蒸	篜
蓉	嫆
蓝	藍
蓬	莑
蔑	篾
蔓	嫚
蔚	墛
蔷	嫱
蔽	幣
蕊	惢
蕴	藴
蕾	檑
薪	蕲
藏	蔵
藐	邈
藕	耦
藤	駦
蘑	嚤
虎	唬
虐	疟
虑	慮
虚	歔
虫	蟲
虹	渱
蚂	犸
蚊	螡
蚕	蛬
蛇	虵
蛋	疍
蛛	咮
蛮	蠻
蛾	睋
蜗	窩
蜘	倁
蜜	滵
蜡	臘
蝴	箶
蝶	渫
融	瀜
血	洫
行	垳
衔	銜
衡	蘅
衣	扆
补	卟
表	錶
衫	釤
衰	缞
袁	媴
袄	仸
袍	垉
袜	襪
裂	煭
装	裝
裙	峮
裤	褲
褂	啩
褪	蹆
襟	噤
西	覀
要	婹
见	見
观	觀
规	規
视	視
览	灠
觉	覺
言	訁
誉	謍
警	檠
计	計
订	忊
认	認
讨	討
让	讓
训	訓
讯	卂
记	汜
讲	講
讶	冴
许	汻
论	囵
设	蔎
访	汸
诀	吷
证	姃
诅	蒩
识	識
诈	怍
诉	訴
诊	沴
词	詞
译	譯
试	鉽
诗	詩
诚	諴
话	話
诡	詭
询	咰
该	姟
详	詳
诬	莁
语	娪
误	誤
说	説
诵	誦
请	埥
诸	渚
诺	喏
读	渎
课	錁
谁	誰
调	蜩
谅	涼
谈	談
谋	湈
谍	媟
谎	巟
谐	喈
谓	媦
谜	洣
谢	塮
谣	愮
谦	嗛
谨	殣
谬	繆
谱	鐠
谷	唂
豆	荳
象	潒
豪	濠
貌	邈
贝	赑
贞	浈
负	萯
贡	貢
财	財
责	嫧
贤	賢
败	敗
货	貨
质	質
贪	貪
贫	貧
贬	貶
购	媾
贯	遦
贱	濺
贴	萜
贵	貴
贸	貿
费	曊
贺	哿
贼	賊
赁	賃
赃	賍
资	粢
赋	賦
赌	帾
赏	賞
赐	賜
赔	婄
赖	攋
赚	賺
赛	噻
赞	瓒
赠	熷
赤	哧
走	趉
赵	趙
赶	迀
超	趫
越	樾
足	娖
趴	汃
跃	跞
跋	柭
跌	瓞
跑	垉
距	岠
跟	茛
跪	蛫
路	蕗
跳	朓
踌	帱
踏	沓
踩	棌
踪	琮
蹄	渧
蹈	稲
蹦	嘣
蹬	簦
蹭	竲
蹲	壿
躁	璪
身	裑
躬	匑
躯	軀
躲	躱
车	車
轨	匦
轩	蓒
转	啭
轮	囵
软	軟
轰	轟
轻	輕
载	酨
较	珓
辆	唡
辈	輩
辉	媈
输	瀭
辖	轄
辛	厗
辞	辭
辟	澼
辨	辧
辩	辮
辫	辮
辰	宸
辱	媷
边	笾
达	垯
迂	扜
迅	卂
过	過
迈	邁
迎	迊
运	運
近	菦
还	還
这	適
进	琎
远	逺
违	違
连	涟
迟	呎
迪	廸
迫	廹
述	沭
迷	洣
迸	逬
追	搥
退	蹆
送	鎹
逃	洮
逆	屰
选	選
逊	遜
逐	豩
途	蒤
逗	浢
通	嗵
逛	迋
逝	迣
逞	浧
速	趚
造	慥
逢	漨
逮	曃
逻	羅
逼	腷
逾	揄
遂	嬘
遇	喁
遍	猵
道	檤
遥	滛
遭	蹧
遮	嗻
遵	噂
避	鐴
邀	撽
邓	郰
邢	郉
那	哪
邦	綁
邪	峫
邵	卲
邻	鄰
郁	喐
郎	蓢
郑	鄭
部	蔀
郭	漷
都	嘟
鄙	啚
酋	媨
配	蓜
酒	氿
酪	絡
酬	絒
酱	醬
醇	錞
醉	酔
醋	齰
醒	瑆
重	偅
野	嘢
量	糧
金	唫
针	針
钉	町
钓	銱
钙	鈣
钝	沌
钞	鈔
钟	妕
钠	妠
钢	鋼
钧	呁
钩	溝
钮	妞
钱	錢
钻	鑽
铁	鉄
铃	玪
铅	鉛
铜	恫
铝	焒
铭	佲
银	檭
铺	舗
链	嗹
锁	鎻
锄	鋤
锅	煱
锈	琇
锋	峯
锐	銳
错	措
锡	唶
锣	囉
锤	腄
锦	婂
键	楗
锯	涺
锻	葮
镇	鎮
镊	嗫
镐	鎬
镜	傹
镭	檑
长	萇
门	閄
闪	閁
闭	閉
问	問
闯	闖
闰	潤
闲	娴
间	簡
闷	悶
闸	閘
闹	閙
闺	閨
闻	聞
闽	閩
阅	閱
阎	閻
阐	闡
阔	闊
队	隊
阮	朊
防	汸
阳	陽
阴	隂
阵	俥
阻	蒩
阿	婀
陀	拕
附	胕
际	漈
陆	陸
陇	茏
陈	陳
陌	帞
降	夅
陕	陝
陡	跿
院	阮
除	篨
陨	殒
险	険
陪	婄
陵	夌
陶	匋
陷	陥
隆	湰
隋	陏
随	隨
隐	陻
难	難
雅	蕥
集	潗
雍	澭
雏	雛
雕	鵰
雪	膤
零	蕶
雷	檑
雾	霚
需	濡
霉	苺
霍	靃
霜	灀
霞	葭
露	蕗
霸	覇
霹	噼
青	圊
静	靜
非	悱
面	媔
革	愅
鞋	嚡
韩	韓
音	堷
韵	韻
页	頁
顶	嵿
顷	頃
项	頙
顺	順
须	湏
顾	顧
顿	頓
颁	頒
颂	頌
预	預
领	領
颇	櫇
颈	頸
频	頻
颖	颕
颗	錁
题	趧
颜	顔
颤	顫
风	颩
飘	彯
飞	飛
食	喰
餐	爘
饭	粄
饮	飮
饰	飾
饱	怉
饵	聶
饶	隢
饿	皒
馁	浽
馅	陥
馆	菅
馈	潰
馋	镵
馒	獌
首	渞
香	萫
马	骉
驮	駞
驯	紃
驰	肔
驱	駆
驳	訤
驴	馿
驶	馶
驼	袉
驾	駕
骂	罵
骄	嬌
骆	詻
验	験
骏	浚
骑	騏
骗	騙
骚	騒
骨	嗗
高	滈
鬼	媿
魏	蘶
魔	嚤
鱼	渔
鲁	噜
鲜	鮮
鲸	鯨
鳞	潾
鸟	茑
鸡	鶏
鸣	嘄
鸥	瓯
鸦	鴉
鸭	鴨
鸯	鴦
鸳	鴛
鸵	袉
鸿	鴻
鹃	鵑
鹏	鵬
鹿	蔍
麦	麥
麻	嫲
麽	庅
黄	曂
黑	嫼
鼓	鼔
鼠	癙
鼻	嬶
齐	斉
齿	歯
龄	齡
龙	瀧
龟	亀